................
......,,,.......
,,,,,,.....,,,..
????????????????
****************
!!!!!!!!!!!!!!!!
,,,,,,.....,,,..
......,,,.......
................
